....................
....W............X..
...##.......########
....................
WWW.......W.........
---.........WW......
...........####.....
WWW.................
###.........WW.WW...
............#####...
....WWW.............
....###.............
....................
.1........W.W.W.W.W.
####################
Pick up all the waterdrops and reach the exit in time.
