.........W..........
.....WWW...WWW......
***......-..........
.....***....***.....
1..................X
***......WW.....****
.........--.........
W.W.W..........W.W.W
*****..........*****
....................
W.W.W..........W.W.W
******........******
....................
...W.W........W.W...
...****......****...
Watch out, the ice is slippery!
