....................
.....W..............
...@@@..............
..............WWW...
...@@.........WWW...
..........1...WWW...
...@@....@@...WWW...
....W.........@@@...
............. WWW...
...@@.......--WWW...
..............WWW...
............--WWW...
..............WWW...
.X..A...T.....WWW...
######..###...@@@...
There are many drops in the ocean...